%%%%%%%%%%%%%%%%%%%%%%
%...              ...%
%...               ..%
%...                .%
%                    %
%                    %
%                    %
%                 ...%
%P               ....%
%%%%%%%%%%%%%%%%%%%%%%