%%%%%%%%%%%%%%%%%%%%%%
%.                  .%
%                    %
%                    %
%.         .         %
%                    %
%                    %
%                    %
%P                  .%
%%%%%%%%%%%%%%%%%%%%%%