%%%%%%%%%%%%%%%%%%%%%%
%                    %
%                    %
%                    %
%.         .         %
%                    %
%                    %
%                    %
%P                   %
%%%%%%%%%%%%%%%%%%%%%%