%%%%%%%%%%%%%%%%%%%%%%
%          .         %
%                    %
%                    %
%                    %
%                    %
%       %%%%%%%%%    %
%                    %
%          P         %
%%%%%%%%%%%%%%%%%%%%%%